█████████████████████████████
█           █               █
█  $        █               D
█           ████████        █
█       █                   █
█       █           B       █
█       █                   █
█████████████████████████████
